NO ./assets/textures/walls/wall_1.xpm
EA ./assets/textures/walls/wall_4.xpm
SO ./assets/textures/walls/wall_2.xpm
WE ./assets/textures/walls/wall_3.xpm

F 70,70,70
C 70,70,70





11111111111111111111
10000000000000000001
10000000000000000001
100E1010101010101001
10000000000000000001
10000000000000001001
10000000000000001001
10000000000000001001
10000000000001111001
10000000000000000001
10000000000000000001
10000000000000000001
11111111111111111111